{
    "name": "Pac-Man Classic",
    "description": "The original 28x31 Pac-Man maze layout",
    "source": "Based on original Namco Pac-Man (1980)",

    "start": {"x": 14.5, "y": 24.5, "angle": 1.5708},
    "goal": {"x": 14, "y": 12},

    "rows": [
        "############################",
        "#............##............#",
        "#.####.#####.##.#####.####.#",
        "#O####.#####.##.#####.####O#",
        "#.####.#####.##.#####.####.#",
        "#..........................#",
        "#.####.##.########.##.####.#",
        "#.####.##.########.##.####.#",
        "#......##....##....##......#",
        "######.##### ## #####.######",
        "     #.##### ## #####.#     ",
        "     #.##          ##.#     ",
        "     #.## ###--### ##.#     ",
        "######.## #      # ##.######",
        "      .   #      #   .      ",
        "######.## #      # ##.######",
        "     #.## ######## ##.#     ",
        "     #.##          ##.#     ",
        "     #.## ######## ##.#     ",
        "######.## ######## ##.######",
        "#............##............#",
        "#.####.#####.##.#####.####.#",
        "#.####.#####.##.#####.####.#",
        "#O..##................##..O#",
        "###.##.##.########.##.##.###",
        "###.##.##.########.##.##.###",
        "#......##....##....##......#",
        "#.##########.##.##########.#",
        "#.##########.##.##########.#",
        "#..........................#",
        "############################"
    ]
}
